wwwwwwwwwwwww
w...........w
w...........w
w......g.w..w
w....w......w
w.....wwww..w
w...A.......w
w..........+w
wwwwwwwwwwwww