wwwwwwwwwwwww
w...........w
w.......A...w
w..+...www..w
w...........w
w....w...g..w
w....w......w
w....w......w
wwwwwwwwwwwww