wwwwwwwwwwwww
w3...w......w
w..Aw.w.....w
w.........w.w
w..ww.ww..w.w
w......w....w
w3...ww..wg.w
www..w+...1.w
wwwwwwwwwwwww