wwwwwwwwwwwww
w3.........2w
w.....w.....w
w....+w1....w
w..wwwwwww..w
w....Awg....w
w.....w.....w
w2.........3w
wwwwwwwwwwwww