wwwwwwwwwwwww
w...........w
w....w......w
w....Aw.....w
w....w....+.w
w..gw.......w
w..w........w
w...........w
wwwwwwwwwwwww