wwwwwwwwwwwww
w..A......1.w
w......www..w
w.ww.....w..w
w.....ww....w
w.ww....www+w
w1...ww.....w
w...gw1.....w
wwwwwwwwwwwww