wwwwwwwwwwwww
www...A...www
w2..www....2w
w.....w..w..w
w..ww.g.ww..w
w..w..w.....w
w1....www..1w
www...+...www
wwwwwwwwwwwww