wwwwwwwwwwwww
ww.www+....ww
w..www.w..www
w....www.ww.w
www.w.A..ww.w
w...........w
w.wwwwwwwwwww
w.........g.w
wwwwwwwwwwwww