wwwwwwwwwwwww
w....w....g.w
w...www.....w
w.2..www....w
w..wwwwwww..w
w......w....w
w....w...2..w
wA...w+...1.w
wwwwwwwwwwwww