wwwwwwwwwwwww
w.....2..wwww
w..w.+ww....w
w.www.ww....w
w..w22...w..w
w.......www.w
w.gww....w..w
w..ww....A.ww
wwwwwwwwwwwww