wwwwwwwwwwwww
w..........Aw
w.....w1....w
wg..........w
www.........w
w.........w.w
w.........+.w
w.2.........w
wwwwwwwwwwwww