wwwwwwwwwwwww
w1......w..Aw
w.w.....w.www
w.w.w.......w
w+wgwww....ww
w.w.w.......w
w.w.....w...w
w1......w1w1w
wwwwwwwwwwwww