wwwwwwwwwwwww
ww3........1w
wgw...w.....w
w.Aw...w....w
w...w...w...w
w....w...w..w
w.....w...w+w
w1........2ww
wwwwwwwwwwwww