wwwwwwwwwwwww
w.....gw....w
w.wwwww..ww.w
w.......w...w
wwwwwwww..www
w..A..w..w..w
w.......w..+w
w...........w
wwwwwwwwwwwww