wwwwwwwwwwwww
w1...w.....1w
w..w......www
w....www.gw+w
www.w.A.www.w
w...w...w...w
w.w.....w...w
w1..w.......w
wwwwwwwwwwwww