wwwwwwwwwwwww
w.Aww....2..w
w......w....w
wwww..ww..www
www..wwww..ww
ww..www3..www
w...w...ww..w
w..g..w...+.w
wwwwwwwwwwwww