wwwwwwwwwwwww
w1..w...w...w
w.ww.Aw..2w.w
w.w...w...w.w
w....www..w.w
w.ww..w.+ww.w
w..ww.w..w..w
w...3gw....ww
wwwwwwwwwwwww