wwwwwwwwwwwww
w..A........w
w.wwwww..ww.w
w.w.......g.w
w....w...ww.w
w..ww.ww..www
w...+..ww...w
w...........w
wwwwwwwwwwwww