wwwwwwwwwwwww
w........w..w
w..w.....w22w
w1.wwwww....w
w......w....w
w..w...www..w
w+www.......w
w..w....wwAgw
wwwwwwwwwwwww