wwwwwwwwwwwww
w...........w
w.....w.....w
w.....w.....w
w....w......w
w....Aw+wg..w
w.......w...w
w...........w
wwwwwwwwwwwww