wwwwwwwwwwwww
w...........w
w..2+.......w
w....ww.....w
w.....w.....w
w....Awww...w
w...........w
w.......g...w
wwwwwwwwwwwww