wwwwwwwwwwwww
w..3........w
www..g.www..w
wwww........w
w...A..www..w
w1.....ww...w
w..3.www.+www
w..3...w...ww
wwwwwwwwwwwww